11111111111111111
1E000P00000C000C1
101001010010E0001
10100100101010101
100000000C00C0001
11111111111111111