11111111111111111
1E000P00000000001
101001010010EC001
1010C100101010101
10000000C00000001
11111111111111111