1111111111111111111
1E1000001C100100001
1010010100101C10101
1010000000000000101
1010010000100000001
10100000C00E00P0001
1010010000000100101
1010000000100000001
1000010010101010101
1111111111111111111