111111111111111111111
100000000000000000001
1000C0000000000000001
100111001110011110001
100000000E000000X0001
110001111001110001111
100000000000000000001
100111001110011110001
1000000000000000000P1
111111111111111111111